R 800 800

NO ./1-2.xpm
SO ./1-1.xpm
WE ./1-4.xpm
EA ./1-3.xpm
S ./1-5.xpm

F            37,37,30
C 86,          197    , 255  

11111111
1010000111111111111111111111111
1000000000000000000002220000001
1000000000000000000000000000001
1000000002000000000000N00000001
1000000000000000000000000000001
1000000002000000020000000000001
1000000000000000000002220000001
1111111111111111111111111111111
