R 1200 1200

NO ./1-2.xpm
SO ./1-1.xpm
WE ./1-4.xpm
EA ./1-3.xpm

S ./1-5.xpm

F            37,37,37
C 86,          197    , 255  

11111111
1210000111111111111111111111111
1000000000002000000002220000001
1000000000000000000000000000001
1000000002000000000000000000001
1000000000000000000000000000001
1000N00002000000020000000000001
1111111111111111111111111111111

             111111111111
             122200000001
             122200000021
             122200000001
             111100011111
                10001111111111     
      111111111110001000001001
      100000000000001000001001
      111111111111001000001001
                 1001000001001
        1111111111001110111001
        1000000000000000000001
        1101111111111111011111
        10001          101
        11011          101
        10001          101
        10001          111
        11111

