R 1920 1080

NO ./path_to_the_north_texture.xpm
SO ./path_to_the_south_texture
WE ./path_to_the_west_texture
EA ./path_to_the_east_texture

S ./path_to_the_sprite_texture

F 220,100,0
C 225,30,0

     111111111111
     100000000001
     1111N0011111
        10001     1111
1111111110001     1001
1000000000001     1001111111
1111111111001     1000000001
         1001     1001111111
1111111111001111111001
1000000000000000000001
1111111111111111111111