R 1200              1200

NO ./1-2.xpm
SO ./1-3.xpm
WE ./1-2.xpm
EA ./1-1.xpm

S ./1-5.xpm

F 37,37,37
C 86,197,255

             111111111111
             120000000001
             1122000N0021
             100000000001
             111120011111
                10001111111111     
      111111111110001000001001
      100000000000001000001001
      111111111111001000001001
                 1001000001001
        1111111111001110111001
        1000000000000000000001
        1101111111111111011111
        10001          101
        11011          101
        10001          101
        10001          111
        11111