R 1200              1200

NO ./1-4.xpm
SO ./1-3.xpm
WE ./1-2.xpm
EA ./1-1.xpm

S ./path_to_the_sprite_texture

F 220,100,12
C 225,30,12

     111111111111
     120000000001
     10000N000001
     100000000001
     111100011111
        10001111111111     
1111111110001000001001
1000000000001000001001111111
1111111111001000001000000001
         1001000001001111111
1111111111001110111001

1000000000000000000001
1111111111111111111111